{
    "citywide": {"citywide": 1},
    "council_districts": {
        "1": 2,
        "2": 3,
        "3": 4,
        "4": 5,
        "5": 6,
        "6": 7,
        "7": 8
    },
    "neighborhood_zones": {
        "1a": 9,
        "1b": 10,
        "1c": 11,
        "2a": 12,
        "2b": 13,
        "2c": 14,
        "3a": 15,
        "3b": 16,
        "3c": 17,
        "4a": 18,
        "4b": 19,
        "4c": 20,
        "5a": 21,
        "5b": 22,
        "5c": 23,
        "5d": 24,
        "6a": 25,
        "6b": 26,
        "6c": 27,
        "6d": 28,
        "7a": 29,
        "7b": 30,
        "7c": 31
    }
}
